NO    ./imgs/cc2.xpm
SO           ./imgs/cc.xpm
WE      ./imgs/cc.xpm
EA./imgs/cc.xpm
F 255, 0, 93
C 255, 182, 193
11111111111111111111111111111111
1N0000000010000000000000000000001
100000000000000001000000000000001
10000000000000001 100000000000001
100000000000000001000000010000001
111111111111111111111111111111111
