111111111111111111111111111111111111111111111111111111
100000000000000C000000000000000000000000010C0000000001
100000000000000000000100001000000000000000000000000001
100000000P000000000111000010000C00000011100000000000E1
100000000000000000000000001000000000000000000010000001
10000000000000000000000000000000000000000C000000000001
111111111111111111111111111111111111111111111111111111
