1111111111111111111
1E100000E000001C101
10110101001000C0011
1011100101000P00111
10000000C00C0000C11
1111111111111111111
